 ##### #########
##...###.......#
#u@..|.|.....R.#
##...###.......#  
 ##### #####.###
           #.#
           #.#######
           #.|.R..d#
           #########