################
#..............#
#..u......h....#
#..............#
################