################
#..............#
#..u......h..S.#
#..............#
################