      #####
      #u..#
      ###.#
        #.#
        #.#
        #.###
####### #...#
#...|.###t#.#
#.###.......#
#.#R|b######
#.#####
#.#
#.#####
#.....#
#t###.#
#d###.#
#..##.#
##....#
 ######