################
#..............##
#..u.........S.d#
#..............##
################